00000000000000000000000000000000
00000000000000000000000000000000
000000000xxxxxx00000000000000000
000000000x0000000000000000000000
000000000xgx000000000xxx00000000
000000000xxx000000000x0x00000000
00000x00000x000000000xxx00000000
00xx0000000x00x00000000000000000
000xx000000x00x0000000000000x000
0x0x0000000x00x00000000000000000
0i00x000000x00x00000000000000000
0000000000000000x000000000000000
000000000000000000000xx00000x000
0000000000000000x00000000000x000
0000000000000000000000000000x000
00000000000000000000000000000000
